------------
------------
--------|---
--||--------
---|---|||--
------------
------------